 #####   #### 
 #   #####  ##
 #     X     #
 ##O#######  #
  #O#  P  # ##
###O#    X#  #
#   ## # X   #
#       ###  #
##  #   # ####
 ########     
