########### 
#         # 
# # #XX#X # 
# # #  X  # 
#   X  #  # 
# # #  #####
# # ####   #
# X   P  OO#
######## OO#
       # OO#
       #####
