######
#  XO#
# P  #
#  XO#
######
